{
    "pattern": [
        ["00","00","00","01","02","03","03","02","01","03","04","01","02","01","03","04","03","02","01","03","03","04","02","01","01","01","01","03","02","01"],
        ["01","01","02","00","00","00","00","00","00","00","00","00","00","00","00","00","00","00","00","00","00","00","00","00","02","03","00","00","00","04"],
        ["01","03","00","00","01","03","02","04","03","04","01","00","01","02","04","03","02","00","02","03","04","03","04","00","00","68","00","91","00","03"],
        ["01","04","00","00","60","00","60","00","00","00","02","00","04","00","00","00","01","00","00","00","00","00","00","01","00","02","00","00","00","04"],
        ["01","00","00","01","02","04","00","00","21","00","03","00","02","00","01","00","00","00","01","03","04","02","00","02","00","03","04","68","02","01"],
        ["03","00","00","04","9B","00","60","00","00","00","02","00","03","00","00","00","00","00","00","00","00","00","00","03","00","02","03","00","03","02"],
        ["01","02","00","02","03","01","00","00","01","03","04","00","04","02","01","03","00","01","02","04","00","00","01","04","00","04","01","00","04","01"],
        ["01","01","00","00","00","00","60","01","00","00","00","00","00","00","00","04","00","00","00","00","00","01","00","00","00","00","00","00","00","03"],
        ["04","00","00","00","00","00","00","02","00","03","01","00","89","02","00","00","04","03","02","01","00","02","00","02","01","00","02","01","04","01"],
        ["03","00","02","04","03","02","00","04","00","00","04","00","00","00","04","00","00","00","00","02","00","04","00","2B","02","00","03","00","02","01"],
        ["02","00","00","00","00","04","00","00","00","00","02","01","03","00","01","02","03","04","00","00","00","03","00","12","03","00","00","00","00","02"],
        ["03","00","04","01","00","02","03","04","03","00","00","12","01","00","21","21","21","21","04","03","02","02","00","03","00","00","1C","00","03","01"],
        ["02","00","01","00","00","00","00","00","00","04","00","02","21","00","00","00","00","00","00","00","00","04","00","02","00","00","00","00","00","03"],
        ["01","02","03","00","01","00","01","02","00","01","02","04","21","00","00","00","00","00","71","03","00","01","00","01","04","00","04","01","02","01"],
        ["A8","00","00","00","02","00","03","04","00","00","00","01","21","00","00","00","00","00","71","04","00","00","00","03","0B","00","81","01","01","01"],
        ["01","01","02","60","04","00","00","00","02","03","00","02","21","00","00","00","00","00","71","01","04","01","00","04","02","00","02","01","03","01"],
        ["03","00","04","00","03","02","01","00","00","04","00","00","00","00","00","00","00","00","71","02","03","03","00","02","00","00","00","00","00","02"],
        ["04","00","02","00","00","00","00","04","00","01","02","04","03","21","21","21","21","00","04","00","00","02","00","01","00","00","01","02","04","01"],
        ["04","00","00","00","04","02","00","03","00","00","00","01","02","03","04","02","03","00","02","00","00","00","00","00","04","00","00","00","00","02"],
        ["03","00","00","00","00","00","00","02","00","02","00","00","00","01","03","00","00","00","01","00","01","03","02","00","00","03","02","00","03","00"],
        ["00","02","03","00","01","02","00","01","00","00","03","02","00","04","02","00","02","03","04","00","00","00","00","04","00","01","21","00","00","03"],
        ["00","12","02","00","04","03","00","01","00","00","01","04","00","00","00","00","00","00","00","01","00","00","01","02","00","00","03","00","04","00"],
        ["01","00","00","00","00","04","00","03","00","00","01","02","04","03","02","03","04","01","04","01","02","12","04","00","04","00","01","00","00","01"],
        ["00","01","03","60","01","02","60","04","00","00","00","00","00","01","02","00","00","00","00","03","12","02","00","00","01","00","02","60","01","00"],
        ["00","04","00","00","03","00","00","02","00","00","01","02","00","00","00","00","02","04","00","00","00","00","00","00","02","00","01","00","12","00"],
        ["00","02","68","01","00","03","00","03","00","00","04","02","03","04","04","03","00","00","00","00","00","00","00","02","03","00","04","00","03","00"],
        ["01","00","00","00","04","00","00","04","00","00","00","00","00","00","00","00","00","00","02","00","00","21","60","00","01","00","03","00","01","01"],
        ["02","00","A1","00","68","00","02","03","02","03","02","01","04","03","02","04","01","00","00","00","00","60","00","00","04","00","01","00","00","03"],
        ["03","78","00","00","04","03","00","00","00","00","00","00","00","00","00","00","00","02","01","04","12","04","00","00","01","00","02","04","03","00"],
        ["04","03","02","01","01","00","00","00","00","00","00","00","00","00","00","00","00","00","00","00","00","01","04","03","02","00","01","00","00","00"]
    ],
    "types": {
        "00": "none",
        "01": "house1",
        "02": "house2",
        "03": "house3",
        "04": "house4",
        "0B": "guild",
        "12": "tavern",
        "1C": "shop",
        "21": "temple",
        "2B": "review_board",
        "60": "statue",
        "68": "gate",
        "71": "madgod_temple",
        "78": "sewer_entrance",
        "81": "credits",
        "89": "roscoe",
        "91": "kylearans_tower",
        "9B": "harkyns_castle",
        "A1": "mangars_tower",
        "A8": "city_gate"
    },
    "taverns": [],
    "temples": [],
    "statues": [],
    "messages": [],
    "streets": [
        ["01","01","01","01","02","03","03","02","01","03","04","01","02","01","03","04","03","02","01","03","03","04","02","01","01","01","01","03","02","01"],
        ["01","01","02","0C","0C","0C","0C","0C","0C","0C","0C","0C","0C","0C","0C","0C","0C","0C","0C","0C","0C","0C","0C","0C","02","03","0C","0C","0C","04"],
        ["01","03","0C","0C","01","03","02","04","03","04","01","05","01","02","04","03","02","00","02","03","04","03","04","0C","0C","0C","0C","31","0C","03"],
        ["01","04","00","00","00","00","00","00","00","00","02","05","04","06","06","06","01","06","06","06","06","06","06","01","00","02","0C","08","0C","04"],
        ["01","00","00","01","02","04","00","00","21","00","03","05","02","06","01","06","06","06","01","03","04","02","06","02","00","03","04","08","02","01"],
        ["03","00","00","04","03","00","00","00","00","00","02","05","03","06","06","06","06","06","06","06","06","06","06","03","00","02","03","08","03","02"],
        ["01","02","00","02","03","01","00","00","01","03","04","05","04","02","01","03","00","01","02","04","00","00","01","04","00","04","01","08","04","01"],
        ["01","01","11","11","11","11","11","01","0E","0E","0E","05","00","00","00","04","00","00","00","00","00","01","02","02","02","02","02","08","02","03"],
        ["04","11","11","11","11","11","11","02","00","03","01","05","01","02","00","00","04","03","02","01","00","02","04","02","01","03","02","01","04","01"],
        ["03","00","02","04","03","02","11","04","00","00","04","05","00","00","04","00","00","00","00","02","00","04","04","2B","02","03","03","00","02","01"],
        ["02","12","12","12","12","04","11","11","11","11","02","01","03","00","01","02","03","04","00","00","00","03","04","12","03","03","00","00","00","02"],
        ["03","00","04","01","12","02","03","04","03","11","11","12","01","00","21","21","21","21","04","03","02","02","04","03","03","03","1C","00","03","01"],
        ["02","00","01","0D","12","12","12","12","12","04","11","02","21","FF","FF","FF","FF","FF","FF","FF","FF","04","04","02","03","03","00","00","00","03"],
        ["01","02","03","0D","01","00","01","02","12","01","02","04","21","FF","FF","FF","FF","FF","21","03","00","01","04","01","04","03","04","01","02","01"],
        ["01","00","00","0D","02","00","03","04","12","12","12","01","21","FF","FF","FF","FF","FF","21","04","00","00","04","03","0B","03","03","01","01","01"],
        ["01","01","02","0D","04","00","00","00","02","03","12","02","21","FF","FF","FF","FF","FF","21","01","04","01","04","04","02","03","02","01","03","01"],
        ["03","00","04","0D","03","02","01","00","07","04","12","12","12","FF","FF","FF","FF","FF","21","02","03","03","04","02","03","03","00","00","00","02"],
        ["04","00","02","0D","00","00","0A","04","07","01","02","04","03","21","21","21","21","00","04","09","09","02","04","01","03","03","01","02","04","01"],
        ["04","00","00","0D","04","02","0A","03","07","0F","0F","01","02","03","04","02","03","00","02","09","09","00","94","09","04","03","03","01","03","02"],
        ["03","00","00","0D","00","00","0A","02","07","02","0F","0F","0F","01","03","00","00","00","01","09","01","03","02","10","10","03","02","01","03","00"],
        ["01","02","03","0D","01","02","0A","01","07","07","03","01","0F","04","02","00","02","03","04","00","00","00","00","04","10","01","21","01","01","03"],
        ["00","12","02","0D","04","03","0A","01","07","07","01","01","0F","0F","0F","0F","0F","0F","0F","01","00","00","01","02","10","10","03","01","04","00"],
        ["01","00","00","0D","00","04","0A","03","07","07","01","02","04","03","02","03","04","01","04","01","02","12","04","00","04","10","01","01","01","01"],
        ["01","01","03","0D","01","02","0A","04","07","07","13","13","13","01","02","13","13","13","13","03","12","02","00","00","01","10","02","01","01","00"],
        ["01","04","0D","0D","03","0A","0A","02","07","07","01","02","13","13","13","13","02","04","13","13","13","13","13","13","02","10","01","01","12","00"],
        ["01","02","0D","01","02","03","0A","03","07","07","04","02","03","04","04","03","0B","0B","0B","0B","0B","0B","0B","02","03","10","04","01","03","00"],
        ["01","0D","0D","0D","04","0A","0A","04","0B","0B","0B","0B","0B","0B","0B","0B","0B","0B","02","0B","0B","21","0B","0B","01","10","03","01","01","01"],
        ["02","0D","01","0D","00","00","02","03","02","03","02","01","04","03","02","04","01","0B","0B","0B","0B","0B","0B","0B","04","10","01","01","01","03"],
        ["03","0D","0D","0D","04","03","00","00","00","00","00","00","00","00","00","00","00","02","01","04","12","04","0B","0B","01","10","02","04","03","00"],
        ["04","03","02","01","01","00","00","00","00","00","00","00","00","00","00","00","00","00","00","00","00","01","04","03","02","10","01","00","00","00"]
    ],

    "street_names": {
        "00": "Alley",
        "01": "Rakhir",
        "02": "Blacksmith",
        "03": "Main",
        "04": "Trumpet",
        "05": "Gray Knife",
        "06": "Stonework",
        "07": "Emerald",
        "08": "Hawk Scabard",
        "09": "Bard Blazon",
        "0A": "Tempest",
        "0B": "Fargoer",
        "0C": "a Blue Highway",
        "0D": "Night Archer",
        "0E": "Serpentskin",
        "0F": "Corbomite",
        "10": "Sinister",
        "11": "Marksman",
        "12": "Dilvish",
        "13": "Death Archer",
        "FF": "Grand Plaz"
    },
    "foo": "// ['the statue of a Samurai warrior', 'the statue of a Stone giant', 'the statue of an Ogre Lord', 'a stone Golem', 'the statue of a Grey Dragon']"
}
