{
  "antimagicZones": [],
  "cityExitPosition": [28, 5],
  "darkness": [],
  "encounters": [],
  "goesDown": true,
  "hitpointDamage": [],
  "levelTeleport": [
    [0, true],
    [1, true],
    [2, true],
    [3, true]
  ],
  "map": [
    "+----------------------------------------------------------------+",
    "|0  1  2  3  4  5  6  7  8  9  0  1  2  3  4  5  6  7  8  9  0  1|",
    "| .------------------------------------------------------------. |",
    "| |+----------------------------------------------------------+| |",
    "|0||                                                          ||0|",
    "| || .------. .------------. .. .. .------------------------. || |",
    "| || |+-++-+| |+-------++-+| .. .. |+-++-------------------+| || |",
    "|9|| || || || ||       || ||       || ||                   || ||9|",
    "| || |+-++-+| || .. .--+| || .. .. || || .---------------. || || |",
    "| || |+----+| || .. |+-+| || .. .. || || |+-------------+| || || |",
    "|8|| DD    DD ||    || || ||       || || ||             || || ||8|",
    "| || |+----+| |+----++D+| || .. .. || || || .---. .---. || || || |",
    "| || |+-++-+| .-----++D+| || .. .. || || || |+-+| |+-+| || || || |",
    "|7|| || || ||       || || ||       || || || || || || || || || ||7|",
    "| || || || || .---. || || || .. .. || || || |+-+| |+-+| || || || |",
    "| || || || || |+-+| || || || .. .. || || || .---. .---. || || || |",
    "|6|| || || || || || DD || ||       || || ||             || || ||6|",
    "| || |+-++-+| || || |+-+| || .. .. || || || .---. .. .--+| || || |",
    "| || |+----+| || || |+-+| || .. .. || || || |+-+| || |+--. || || |",
    "|5|| ||    || || || || || ||       || || || || || || ||    || ||5|",
    "| || |+--. || || || || || || .. .. || || || |+-+| || || .. || || |",
    "| || |+-+| || || || || || || .. .. || || || .---. || || .. || || |",
    "|4|| || || || || || || || ||       || || ||       || ||    || ||4|",
    "| || || || || || |+-+| || || .---. || || |+-------+| || .. || || |",
    "| || || || || || .---. || || |+-+| || || .--------+| || .. || || |",
    "|3|| || || || ||       || || || || || ||          || ||    || ||3|",
    "| || |+-++-+| |+-------++-+| |+-+| |+-++----------++D++----+| || |",
    "| || .------. .------------. .---. .----------------D-------. || |",
    "|2||                                                          ||2|",
    "| || .. .. .. .. .. .. .---. .. .. .---. .. .. .. .. .. .. .. || |",
    "| || .. .. .. .. .. .. |+-+| .. .. |+-+| .. .. .. .. .. .. .. || |",
    "|1||                   || ||       || ||                      ||1|",
    "| || .. .. .. .. .. .. |+-+| .. .. |+-+| .. .. .. .. .. .. .. || |",
    "| || .. .. .. .. .. .. .---. .. .. .---. .. .. .. .. .. .. .. || |",
    "|0||                                                          ||0|",
    "| || .------. .------------. .---. .-------------------D----. || |",
    "| || |+----+| |+----------+| |+-+| |+----------------++D++-+| || |",
    "|9|| ||    || ||          || || || ||                || || || ||9|",
    "| || |+----+| || .---. .. || |+-+| || .--------------+| || || || |",
    "| || |+-++-+| || |+-+| .. || .---. || |+-------------+| || || || |",
    "|8|| DD || DD || || ||    ||       || ||             || || || ||8|",
    "| || |+-++-+| || || || .. || .. .. || || .-----------+| || || || |",
    "| || |+----+| || || || .. || .. .. || || |+-++-++-++-+| || || || |",
    "|7|| ||    || || || ||    ||       || || || || || || || || || ||7|",
    "| || || .. || || || || .. || .. .. || || || |+D++D++D+| || || || |",
    "| || || .. || || || || .. || .. .. || || || |+D--D--D-. || || || |",
    "|6|| ||    || || || ||    ||       || || || DD          || || ||6|",
    "| || |+--. || |+-+| || .. || .. .. || || |+-+| .. .. .. || || || |",
    "| || |+-+| || .---. || .. || .. .. || || |+-+| .. .. .. || || || |",
    "|5|| DD || ||       ||    ||       || || || DD          || || ||5|",
    "| || || || || .-----+| .. || .. .. || || |+-+| .. .. .. || || || |",
    "| || || || || |+-----. .. || .. .. || || |+-+| .. .. .. || || || |",
    "|4|| || || || ||          ||       || || || DD          || || ||4|",
    "| || || || || || .. .. .. || .. .. || || || |+D--D--D--D+| || || |",
    "| || || || || || .. .. .. || .. .. || || || |+D++D++D++D+| || || |",
    "|3|| || || || ||          ||       || || || || || || || || || ||3|",
    "| || || |+-+| || .. .. .. || .. .. || || |+-++-++-++-++-+| || || |",
    "| || || .--+| || .. .. .. || .. .. || || .---------------. || || |",
    "|2|| ||    || ||          ||       || ||                   || ||2|",
    "+-+| |+----+| |+----------+| .. .. |+-++-------------------+| || |",
    "+--. .------. .------------. .. .. .------------------------. || |",
    "|1                                                            ||1|",
    "| .. .--------------------------------------------------------+| |",
    "| .. |+--------------------------------------------------------. |",
    "|0  1||2  3  4  5  6  7  8  9  0  1  2  3  4  5  6  7  8  9  0  1|",
    "+----++----------------------------------------------------------+"
  ],
  "messages": [
    [
      [1, 1],
      "This is the wine cellar of the Scarlet Bard. The air is musty with old wine."
    ],
    [[18, 10], "Rare wines - 5O years and older. Keep Out!"],
    [[17, 12], "Fine wines - 1O years and older. For regular customers only."]
  ],
  "monsterDifficulty": 0,
  "phaseDoor": true,
  "portalDown": [],
  "portalUp": [],
  "randomEncounter": [
    [2, 18],
    [3, 18],
    [7, 16],
    [17, 13],
    [2, 8],
    [3, 8],
    [15, 7],
    [2, 5],
    [15, 3],
    [17, 3]
  ],
  "shortName": "Cellars",
  "smokeZones": [],
  "specialPrograms": [],
  "specialsOther": [
    [17, 12],
    [10, 11],
    [18, 10],
    [1, 1]
  ],
  "spellpointRestore": [],
  "spinners": [[10, 11]],
  "stairsNext": [[7, 18]],
  "stairsPrevious": [[0, 0]],
  "stasisChambers": [],
  "teleports": [],
  "traps": [[16, 16]],
  "wallStyle": "Cellar"
}
