{
  "fullName": "Wine Cellar",
  "cityExitPosition": [27, 5],
  "dim": [22, 22],
  "specialProgramsInfo": [],
  "lights": [
    [[1, 5], { "color": "lightyellow" }],
    [[18, 10], { "color": "lightyellow" }]
  ],
  "videoScreens": [
    [[2, 3], 1, 0, {}],
    [[2, 4], 1, 1, {}],
    [[3, 3], 3, 2, {}],
    [[3, 4], 3, 3, {}],
    [[0, 1], 0, 0, {}],
    [[1, 1], 0, 1, {}]
  ],
  "videoFields": [
    [12, 2], [3, 2],
    [2, 3], [3, 3],
    [2, 4], [3, 4],
    [2, 5], [3, 5],
    [0, 1], [1, 1]
  ],
  "map": [
    "+----------------------------------------------------------------+",
    "|0  1  2  3  4  5  6  7  8  9  0  1  2  3  4  5  6  7  8  9  0  1|",
    "| .------------------------------------------------------------. |",
    "| |+----------------------------------------------------------+| |",
    "|0||                                                          ||0|",
    "| || .------. .------------. .. .. .------------------------. || |",
    "| || |+-++-+| |+-------++-+| .. .. |+-++-------------------+| || |",
    "|9|| || || || ||       || ||       || ||                   || ||9|",
    "| || |+-++-+| || .. .--+| || .. .. || || .---------------. || || |",
    "| || |+----+| || .. |+-+| || .. .. || || |+-------------+| || || |",
    "|8|| DD    DD ||    || || ||       || || ||             || || ||8|",
    "| || |+----+| |+----++D+| || .. .. || || || .---. .---. || || || |",
    "| || |+-++-+| .-----++D+| || .. .. || || || |+-+| |+-+| || || || |",
    "|7|| || || ||       || || ||       || || || || || || || || || ||7|",
    "| || || || || .---. || || || .. .. || || || |+-+| |+-+| || || || |",
    "| || || || || |+-+| || || || .. .. || || || .---. .---. || || || |",
    "|6|| || || || || || DD || ||       || || ||             || || ||6|",
    "| || |+-++-+| || || |+-+| || .. .. || || || .---. .. .--+| || || |",
    "| || |+----+| || || |+-+| || .. .. || || || |+-+| || |+--. || || |",
    "|5|| ||    || || || || || ||       || || || || || || ||    || ||5|",
    "| || |+--. || || || || || || .. .. || || || |+-+| || || .. || || |",
    "| || |+-+| || || || || || || .. .. || || || .---. || || .. || || |",
    "|4|| || || || || || || || ||       || || ||       || ||    || ||4|",
    "| || || || || || |+-+| || || .---. || || |+-------+| || .. || || |",
    "| || || || || || .---. || || |+-+| || || .--------+| || .. || || |",
    "|3|| || || || ||       || || || || || ||          || ||    || ||3|",
    "| || |+-++-+| |+-------++-+| |+-+| |+-++----------++D++----+| || |",
    "| || .------. .------------. .---. .----------------D-------. || |",
    "|2||                                                          ||2|",
    "| || .. .. .. .. .. .. .---. .. .. .---. .. .. .. .. .. .. .. || |",
    "| || .. .. .. .. .. .. |+-+| .. .. |+-+| .. .. .. .. .. .. .. || |",
    "|1||                   || ||       || ||                      ||1|",
    "| || .. .. .. .. .. .. |+-+| .. .. |+-+| .. .. .. .. .. .. .. || |",
    "| || .. .. .. .. .. .. .---. .. .. .---. .. .. .. .. .. .. .. || |",
    "|0||                                                          ||0|",
    "| || .------. .------------. .---. .-------------------D----. || |",
    "| || |+----+| |+----------+| |+-+| |+----------------++D++-+| || |",
    "|9|| ||    || ||          || || || ||                || || || ||9|",
    "| || |+----+| || .---. .. || |+-+| || .--------------+| || || || |",
    "| || |+-++-+| || |+-+| .. || .---. || |+-------------+| || || || |",
    "|8|| DD || DD || || ||    ||       || ||             || || || ||8|",
    "| || |+-++-+| || || || .. || .. .. || || .-----------+| || || || |",
    "| || |+----+| || || || .. || .. .. || || |+-++-++-++-+| || || || |",
    "|7|| ||    || || || ||    ||       || || || || || || || || || ||7|",
    "| || || .. || || || || .. || .. .. || || || |+D++D++D+| || || || |",
    "| || || .. || || || || .. || .. .. || || || |+D--D--D-. || || || |",
    "|6|| ||    || || || ||    ||       || || || DD          || || ||6|",
    "| || |+----|| |+-+| || .. || .. .. || || |+-+| .. .. .. || || || |",
    "| || |+----|| .---. || .. || .. .. || || |+-+| .. .. .. || || || |",
    "|5|| DD    ||       ||    ||       || || || DD          || || ||5|",
    "| || ||    || .-----+| .. || .. .. || || |+-+| .. .. .. || || || |",
    "| || ||    || |+-----. .. || .. .. || || |+-+| .. .. .. || || || |",
    "|4|| ||    || ||          ||       || || || DD          || || ||4|",
    "| || ||    || || .. .. .. || .. .. || || || |+D--D--D--D+| || || |",
    "| || ||    || || .. .. .. || .. .. || || || |+D++D++D++D+| || || |",
    "|3|| ||    || ||          ||       || || || || || || || || || ||3|",
    "| || ||    || || .. .. .. || .. .. || || |+-++-++-++-++-+| || || |",
    "| || ||    || || .. .. .. || .. .. || || .---------------. || || |",
    "|2|| ||    || ||          ||       || ||                   || ||2|",
    "+-+| |+----+| |+----------+| .. .. |+-++-------------------+| || |",
    "+--. .------. .------------. .. .. .------------------------. || |",
    "|1                                                            ||1|",
    "| .. .--------------------------------------------------------+| |",
    "| .. |+--------------------------------------------------------. |",
    "|0  1||2  3  4  5  6  7  8  9  0  1  2  3  4  5  6  7  8  9  0  1|",
    "+----++----------------------------------------------------------+"
  ],
  "_merge": {
    "messages": [
      [[1, 5], "Video conference room - Access strictly prohibited!"]
    ]
  }
}
